NO ./img/no.xpm
SO ./img/so.xpm
WE ./img/we.xpm
EA ./img/ea.xpm

C 0, 130, 153
F 212, 244, 250



    111111111111
    100000000001
    100000000001
    100000000001
    100000000001
    100000000001
    100000000001
    100000E00001
    100000000001
    100000000001
    100000000001
    111111111111