NO ./img/no.xpm
SO ./img/so.xpm
WE ./img/we.xpm
EA ./img/ea.xpm

C 0, 130, 153
F 212, 244, 250

    111111111111
    100000000001
    100000000001
1111100000000001
1000000001111111
1000000001
1000000001
1000N00001
1000000001
1000000001
1000000001
1000000001
1000000001
1000000001
1000000001
1111111111