WE ./img/we.xpm
NO ./img/no.xpm
SO ./img/so.xpm
EA ./img/ea.xpm

C 0, 130, 153
F 212, 244, 250

        1111111111111111111111111
        1000000000110000000000001
        10110000011100000000000E11 
        1001000000000000000000001
111111111011000001110000000000001
100000000011000001110111111111111
11110111111111011100000010001
11110111111111011101010010001
11000000110101011100000010001
10000000000000001100000010001
10000000000000001101010010001
1100000111010101111101111000111
11110111 1110101    101111010001
11111111 1111111 111111111111111