NO ./img/wall_N.xpm
SO ./img/wall_S.xpm
WE ./img/wall_W.xpm
EA ./img/wall_E.xpm

F 255,100,0
C 225,30,0

        1111111111111111111111111      
        1000000000110000000000001      
        1011000001110000000000001
        1001000000000000000000001       
111111111011000001110000000000001
1000000000110000011101111111111111111111111
11110111111111011100000010001       
11110111111111011101010010001       
1100000110101011100000010001
1000000000000001100000010001
10000000000000001101010010001
11000E001110101011111011110N01
11110111 1110101 101111010001
11111111 1111111 111111111111
