NO ./img/wall_N.xpm
SO ./img/wall_S.xpm
WE ./img/wall_W.xpm
EA ./img/wall_E.xpm

F 255,100,0
C 225,30,0

1111111111111111111111111 
100000000000000000000000S
1111111111111111111111111 